room01=
***************
**********TTT**
**********T**T*
**********TTT**
**********T**T*
**********TTT**
***************
***************
***************

