level1=
################
################
################
################
####P###########
################
################
################
####s###########

level2=
################
################
################
################
####P###########
################
#W##############
#WWWWWWW########
s###WH##########

level3=
################
##WWWWW#H#######
#######WW#######
################
####P###########
################
#W######T#######
#W#####W########
sW##p##Ws#######

level4=
###THT##########
##WWWWW#########
#WW###WW########
################
####P###s#######
################
################
###W#W##########
sW##p##Ws#######

level5=
#####W##########
#W#W#W#W########
#W#W#W#W########
#W#W#W#W########
sW#WPW#Ws#######
#W##W##W########
##W##sW#########
###WWW##########
H###p###s#######

level6=
sT##s##Ws#######
T##W#W#WT#######
###W#W##########
#WWW#WWW########
####P###########
#WWW#WWW########
###W#WH#########
###WTW##########
s###s###p#######

level7=
###WHW##########
###WsW##########
###WTW##########
################
####P###########
################
################
####T###########
###TpT##########

level8=
####s###########
####T###########
###TsT##########
##T###T#########
#Ts#P#sT########
##T###T#########
###TsT##########
####T###########
################

level9=
####H###########
sssspssss#######
W#W#W#W#W#######
################
####P###########
################
################
################
s###o###s#######

level10=
################
################
################
################
ooooPoooo#######
ooooooooo#######
################
################
################

