room_start=
**********TTT**
**********T****
***********T***
************T**
**********TTT**
***************
***************
***************
***************

room_end=
**********TTT**
**********T****
**********TTT**
**********T****
*******P**TTT**
***************
***************
***************
***************

room_trap=
*********TTTTT*
***********T***
***********T***
******s****T***
***********T***
***********T***
***************
***************
***************

room_loot=
***********T***
***********T***
***********T***
*******s***T***
***********TTT*
***************
***************
***************
***************

room_danger=
***************
**********TT***
*******ss*T*T**
**********T**T*
**********T**T*
**********T*T**
**********TT***
***************
***************

room_puzzle=
***************
*********TTTT**
*********T***T*
*******s*TTTT**
*********T*****
*********T*****
*********T*****
***************
***************

room_merchant=
***************
*********T***T*
*********TT*TT*
*********T*T*T*
*********T***T*
***************
***************
***************
***************

room_boss=
***************
**********TTT**
**********T**T*
**********TTT**
**********T**T*
**********TTT**
***************
***************
***************

