level1=
a*******P*******
****************
****************
****************
****************
****************
################
################
################

