room01=
***************
****sss***TT***
****sssss*T*T**
**********T**T*
**********T**T*
**********T*T**
**********TT***
***************
***************

room02=
***************
***sss***sss***
**TTTTTTTTTTT**
**T*********T**
**T*********T**
**T*********T**
**TTTTTTTTTTT**
***************
***************

