room01=
**********TTT**
**********T****
**********TTT**
**********T****
*******P**TTT**
***************
***************
***************
***************

room02=
**********WWW**
**********W****
**********WWW**
**********W****
*******P**WWW**
***************
***************
***************
***************

