room01=
***********T***
***********T***
***********T***
*******s***T***
***********TTT*
***************
***************
***************
***************

room02=
***********W***
***********W***
***********W***
***********W***
***********WWW*
***************
***************
***************
***************

