room01=
***************
*********T***T*
*********TT*TT*
*********T*T*T*
*********T***T*
***************
***************
***************
***************

