room01=
***************
*********TTTT**
*********T***T*
*********TTTT**
*********T*****
*********T*****
*********T*****
***************
***************

