room01=
**********TTT**
**********T****
***********T***
************T**
**********TTT**
***************
***************
***************
***************

room02=
**********WWW**
**********W****
***********W***
************W**
**********WWW**
***************
***************
***************
***************

