room01=
#########TTTTT#
###########T###
###########T###
###########T###
###########T###
###########T###
###############
###############
###############

room02=
#########WWWWW#
###########W###
###########W###
###########W###
###########W###
###########W###
###############
###############
###############

room03=
T#T#T#T#T#T#T#T
#T#T#T#T#T#T#T#
T#T#T#T#T#T#T#T
#T#T#T#T#T#T#T#
T#T#T#T#T#T#T#T
#T#T#T#T#T#T#T#
T#T#T#T#T#T#T#T
#T#T#T#T#T#T#T#
T#T#T#T#T#T#T#T

