{
    "index": 0,
    "width": 3,
    "height": 3,
    "seed": 0,
    "roomWidth": 11,
    "roomHeight": 11
}
$
------------------------------------------------------------------
------------------------------------------------------------------
------------------------------------------------------------------
------------------------------------------------------------------
------------------------------------------------------------------
--------------------------#0#0#0E0#0#0#0--------------------------
------------------------#0**************#0------------------------
----------------------#4********C0********#5----------------------
----------------#4#0#5#2******************#3#4#0#5----------------
----------------#2**P3P2******************P3P2**#3----------------
----------------#6P1#7#E#1#1#1#1P1#1#1#1#1#7#6P1#7----------------
--------------#4#0P0#3----#0#0#0P0#0#0#0----#4P0#0#5--------------
------------#0******#3--#4**************#5--#2******#0------------
----------#2********#3#2******************#3#2********#3----------
----------#2********#3#2******************#3#2********#3----------
----------#2********#3#2******************#3#2********#3----------
----------#2****@@**P3P2******************P3P2********#3----------
----------#2********#3#2******************#3#2********#3----------
----------#2********#3#2******************#3#2********#3----------
----------#2********#3#2******************#3#2********#3----------
------------#0******#3--#6**************#7--#2******#0------------
--------------#6#1P1#7-S--#1#1#1P1#1#1#1----#6P1#1#7--------------
----------------#4P0#5#4#0#0#0#0P0#0#0#0#0#5#4P0#5----------------
----------------#2**P3P2******************P3P2**#3----------------
----------------#6#1#7#2******************#3#6#1#7----------------
----------------------#6******************#7----------------------
------------------------#0**************#0------------------------
--------------------------#1#1#1#1#1#1#1--------------------------
------------------------------------------------------------------
------------------------------------------------------------------
------------------------------------------------------------------
------------------------------------------------------------------
------------------------------------------------------------------
$
====
{
    "index": 1,
    "width": 5,
    "height": 5,
    "seed": 0,
    "roomWidth": 11,
    "roomHeight": 11
}
$
------------------------------------------------------#0------------------------------------------------------
----------------------------------------------------#0E1#0----------------------------------------------------
--------------------------------------------------#0******#0--------------------------------------------------
------------------------------------------------#0**********#0------------------------------------------------
----------------------------------------------#0**************#0----------------------------------------------
--------------------------------------------#0******************#0--------------------------------------------
------------------------------------------#0**********#0**********#0------------------------------------------
----------------------------------------#0**********#0E0#0**********#0----------------------------------------
--------------------------------------#0**********#0******#0**********#0--------------------------------------
------------------------------------#0**********#0**********#0**********#0------------------------------------
----------------------------------#0******#0#S#0#0#1#1P1#1#1#0#0#0#0******#0----------------------------------
--------------------------------#0********#3#4#0#0#0#0P0#0#0#0#0#5#0********#0--------------------------------
------------------------------#0**********#3#2******************#3#2**********#0------------------------------
----------------------------#0**********#0#3#2******************#3#2#0**********#0----------------------------
--------------------------#0**********#0**#3#2******************#3#2**#0**********#0--------------------------
------------------------#0**********#0****#3#2******************#3#2****#0**********#0------------------------
----------------------#0******************#3#2******************#3#2******************#0----------------------
--------------------#0********************#3#2******************#3#2********************#0--------------------
------------------#0**********#0**********#3#2******************#3#2**********#0**********#0------------------
----------------#0**********#0************#3#2******************#3#2************#0**********#0----------------
--------------#0**********#0**************#3#2******************#3#2**************#0**********#0--------------
------------#0******#0#1#1#1#1#1P1#1#1#1#1#7#6#1#1#1#1P1#1#1#1#1#7#6#1#1#1#1P1#1#1#1#1#1#0******#0------------
----------#0********#0#4#0#0#0#0P0#0#0#0#0#5#4#0#0#0#0P0#0#0#0#0#5#4********P0****#0#0#5#2********#0----------
--------#0**********#0#2******************#3#2******************#3#2******************#3#2**********#0--------
------#0**********#0#0#2******************#3#2******************#3#2******************#3#2#0**********#0------
----#0**********#0**#3#2******************#3#2******************#3#2******************#3#2**#0**********#0----
--#0**********#0****#3#2******************#3#2******************#3#2******************#3#2****#0**********#0--
#0**********#0**C0**P3P2******************P3P2******************P3P2******************P3P2**C0**#0**********#0
--#0**********#0****#3#2******************#3#2******************#3#2******************#3#2****#0**********#0--
----#0**********#0**#3#2******************#3#2******************#3#2******************#3#2**#0**********#0----
------#0**********#0#0#2******************#3#2******************#3#2******************#3#2#0**********#0------
--------#0**********#0#2******************#3#2******************#3#2******************#3#2**********#0--------
----------#0********#0#6#1#1#1#1P1#1#1#1#1#7#6#1#1#1#1P1#1#1#1#1#7#6#1#1#1#1P1#1#1#1#1#7#0********#0----------
------------#0******#0#0#0#0#0#0P0#0#0#0#0#5#4#0#0#0#0P0#0#0#0#0#5#4#0#0#0#0P0#0#0#0#0#0#0******#0------------
--------------#0**********#0**************#3#2******************#3#2**************#0**********#0--------------
----------------#0**********#0************#3#2******************#3#2************#0**********#0----------------
------------------#0**********#0**********#3#2******************#3#2**********#0**********#0------------------
--------------------#0********************#3#2******************#3#2********************#0--------------------
----------------------#0******************P3P2******************P3P2******************#0----------------------
------------------------#0**********#0****#3#2******************#3#2****#0**********#0------------------------
--------------------------#0**********#0**#3#2******************#3#2**#0**********#0--------------------------
----------------------------#0**********#0#0#2******************#3#0#0**********#0----------------------------
------------------------------#0**********#0#2******************#3#0**********#0------------------------------
--------------------------------#0********#0#6#1#1#1#1P1#1#1#1#1#7#0********#0--------------------------------
----------------------------------#0******#0#0#0#0#0#0P0#0#0#0#0#0#0******#0----------------------------------
------------------------------------#0**********#0**********#0**********#0------------------------------------
--------------------------------------#0**********#0**C0**#0**********#0--------------------------------------
----------------------------------------#0**********#0**#0**********#0----------------------------------------
------------------------------------------#0**********#0**********#0------------------------------------------
--------------------------------------------#0******************#0--------------------------------------------
----------------------------------------------#0**************#0----------------------------------------------
------------------------------------------------#0**********#0------------------------------------------------
--------------------------------------------------#0******#0--------------------------------------------------
----------------------------------------------------#0**#0----------------------------------------------------
------------------------------------------------------#0------------------------------------------------------
$
====
{
    "index": 1,
    "width": 5,
    "height": 5,
    "seed": 0,
    "roomWidth": 11,
    "roomHeight": 11
}
$
--------------------------------------------------------------------------------------------------------------
--------------------------------------------------------------------------------------------------------------
--------------------------------------------------------------------------------------------------------------
--------------------------------------------------------------------------------------------------------------
--------------------------------------------------------------------------------------------------------------
--------------------------------------------------------------------------------------------------------------
------------#4#0#0#0#0#0#0#0#0#0#0#0#0#0#0#0#0#0#0#0#0E1#0#0#0#0#0#0#0#0#0#0#0#0#0#0#0#0#0#0#0#0#5------------
------------#2**********************************************************************************#3------------
------------#2**********************************************************************************#3------------
------------#2**********************************************************************************#3------------
------------#2******#0#1#1#1#1#1P1#1#1#1#1#1#S#1#1#1#1#1#1#1#1#1#1#1#1#1#1#1P1#1#1#1#1#1#0******#3------------
------------#2******#3#4#0#0#0#0P0#0#0#0#0#5#4#0#0#0#0E0#0#0#0#0#5#4#0#0#0#0P0#0#0#0#0#5#2******#3------------
------------#2******#3#2******************#3#2******************#3#2******************#3#2******#3------------
------------#2******#3#2******************#3#2******************#3#2******************#3#2******#3------------
------------#2******#3#2******************#3#2******************#3#2******************#3#2******#3------------
------------#2******#3#2******************#3#2******************#3#2******************#3#2******#3------------
------------#2******P3P2******************P3P2******************P3P2******************P3P2******#3------------
------------#2******#3#2******************#3#2******************#3#2******************#3#2******#3------------
------------#2******#3#2******************#3#2******************#3#2******************#3#2******#3------------
------------#2******#3#2******************#3#2******************#3#2******************#3#2******#3------------
------------#2******#3#2******************#3#2******************#3#2******************#3#2******#3------------
------------#2******#3#6#1#1#1#1P1#1#1#1#1#7#6#1#1#1#1P1#1#1#1#1#7#6#1#1#1#1P1#1#1#1#1#7#2******#3------------
------------#2******#3#4#0#0#0#0P0#0#0#0#0#5#4#0#0#0#0P0#0#0#0#0#5#4#0#0#0#0P0#0#0#0#0#5#2******#3------------
------------#2******#3#2******************#3#2******************#3#2******************#3#2******#3------------
------------#2******#3#2******************#3#2******************#3#2******************#3#2******#3------------
------------#2******#3#2******************#3#2******************#3#2******************#3#2******#3------------
------------#2******#3#2******************#3#2******************#3#2******************#3#2******#3------------
------------#2******P3P2******************P3P2******************P3P2******************P3P2******#3------------
------------#2******#3#2******************#3#2******************#3#2******************#3#2******#3------------
------------#2******#3#2******************#3#2******************#3#2******************#3#2******#3------------
------------#2******#3#2******************#3#2******************#3#2******************#3#2******#3------------
------------#2******#3#2******************#3#2******************#3#2******************#3#2******#3------------
------------#2******#3#6#1#1#1#1P1#1#1#1#1#7#6#1#1#1#1P1#1#1#1#1#7#6#1#1#1#1P1#1#1#1#1#7#2******#3------------
------------#2******#3#4#0#0#0#0P0#0#0#0#0#5#4#0#0#0#0P0#0#0#0#0#5#4#0#0#0#0P0#0#0#0#0#5#2******#3------------
------------#2******#3#2******************#3#2******************#3#2******************#3#2******#3------------
------------#2******#3#2******************#3#2******************#3#2******************#3#2******#3------------
------------#2******#3#2******************#3#2******************#3#2******************#3#2******#3------------
------------#2******#3#2******************#3#2******************#3#2******************#3#2******#3------------
------------#2******P3P2******************P3P2******************P3P2******************P3P2******#3------------
------------#2******#3#2******************#3#2******************#3#2******************#3#2******#3------------
------------#2******#3#2******************#3#2******************#3#2******************#3#2******#3------------
------------#2******#3#2******************#3#2******************#3#2******************#3#2******#3------------
------------#2******#3#2******************#3#2******************#3#2******************#3#2******#3------------
------------#2******#3#6#1#1#1#1P1#1#1#1#1#7#6#1#1#1#1P1#1#1#1#1#7#6#1#1#1#1P1#1#1#1#1#7#2******#3------------
------------#2******#0#0#0#0#0#0P0#0#0#0#0#0#0#0#0#0#0P0#0#0#0#0#0#0#0#0#0#0P0#0#0#0#0#0#0******#3------------
------------#2**********************************************************************************#3------------
------------#2**********************************************************************************#3------------
------------#2**********************************************************************************#3------------
------------#6#1#1#1#1#1#1#1#1#1#1#1#1#1#1#1#1#1#1#1#1#1#1#1#1#1#1#1#1#1#1#1#1#1#1#1#1#1#1#1#1#1#7------------
--------------------------------------------------------------------------------------------------------------
--------------------------------------------------------------------------------------------------------------
--------------------------------------------------------------------------------------------------------------
--------------------------------------------------------------------------------------------------------------
--------------------------------------------------------------------------------------------------------------
--------------------------------------------------------------------------------------------------------------
$
====
{
    "index": 1,
    "width": 5,
    "height": 5,
    "seed": 0,
    "roomWidth": 11,
    "roomHeight": 11
}
$
--------------------------------#0--------------------#0--------------------#0--------------------------------
------------------------------#0**#0----------------#0E1#0----------------#0**#0------------------------------
----------------------------#0******#0------------#0******#0------------#0******#0----------------------------
--------------------------#0**********#0--------#0**********#0--------#0**********#0--------------------------
------------------------#0**************#0----#0**************#0----#0**************#0------------------------
----------------------#0******************#0#0******************#0#0******************#0----------------------
------------------------#0****************#0**********#0**********#0****************#0------------------------
--------------------------#0************#0**********#0E0#0**********#0************#0--------------------------
----------------------------#0********************#0******#0********************#0----------------------------
------------------------------#0****#0**********#0**********#0**********#0****#0------------------------------
--------------------------------#0#0******#0#S#0#0#1#1P1#1#1#0#0#0#0******#0#0--------------------------------
----------#0--------------------#0********#3#4#0#0#0#0P0#0#0#0#0#5#0********#0--------------------#0----------
--------#0**#0----------------#0**********#3#2******************#3#2**********#0----------------#0**#0--------
------#0******#0------------#0**********#0#3#2******************#3#2#0**********#0------------#0******#0------
----#0**********#0--------#0**********#0**#3#2******************#3#2**#0**********#0--------#0**********#0----
--#0**************#0----#0**********#0****#3#2******************#3#2****#0**********#0----#0**************#0--
#0******************#0#0******************#3#2******************#3#2******************#0#0******************#0
--#0****************#0********************#3#2******************#3#2********************#0****************#0--
----#0************#0**********#0**********#3#2******************#3#2**********#0**********#0************#0----
------#0********************#0************#3#2******************#3#2************#0********************#0------
--------#0****#0**********#0**************#3#2******************#3#2**************#0**********#0****#0--------
----------#0#0******#0#1#1#1#1#1P1#1#1#1#1#7#6#1#1#1#1P1#1#1#1#1#7#6#1#1#1#1P1#1#1#1#1#1#0******#0#0----------
----------#0********#0#4#0#0#0#0P0#0#0#0#0#5#4#0#0#0#0P0#0#0#0#0#5#4********P0****#0#0#5#2********#0----------
--------#0**********#0#2******************#3#2******************#3#2******************#3#2**********#0--------
------#0**********#0#0#2******************#3#2******************#3#2******************#3#2#0**********#0------
----#0**********#0**#3#2******************#3#2******************#3#2******************#3#2**#0**********#0----
--#0**********#0****#3#2******************#3#2******************#3#2******************#3#2****#0**********#0--
#0**********#0**C0**P3P2******************P3P2******************P3P2******************P3P2**C0**#0**********#0
--#0**********#0****#3#2******************#3#2******************#3#2******************#3#2****#0**********#0--
----#0**********#0**#3#2******************#3#2******************#3#2******************#3#2**#0**********#0----
------#0**********#0#0#2******************#3#2******************#3#2******************#3#2#0**********#0------
--------#0**********#0#2******************#3#2******************#3#2******************#3#2**********#0--------
----------#0********#0#6#1#1#1#1P1#1#1#1#1#7#6#1#1#1#1P1#1#1#1#1#7#6#1#1#1#1P1#1#1#1#1#7#0********#0----------
----------#0#0******#0#0#0#0#0#0P0#0#0#0#0#5#4#0#0#0#0P0#0#0#0#0#5#4#0#0#0#0P0#0#0#0#0#0#0******#0#0----------
--------#0****#0**********#0**************#3#2******************#3#2**************#0**********#0****#0--------
------#0********************#0************#3#2******************#3#2************#0********************#0------
----#0************#0**********#0**********#3#2******************#3#2**********#0**********#0************#0----
--#0****************#0********************#3#2******************#3#2********************#0****************#0--
#0******************#0#0******************P3P2******************P3P2******************#0#0******************#0
--#0**************#0----#0**********#0****#3#2******************#3#2****#0**********#0----#0**************#0--
----#0**********#0--------#0**********#0**#3#2******************#3#2**#0**********#0--------#0**********#0----
------#0******#0------------#0**********#0#0#2******************#3#0#0**********#0------------#0******#0------
--------#0**#0----------------#0**********#0#2******************#3#0**********#0----------------#0**#0--------
----------#0--------------------#0********#0#6#1#1#1#1P1#1#1#1#1#7#0********#0--------------------#0----------
--------------------------------#0#0******#0#0#0#0#0#0P0#0#0#0#0#0#0******#0#0--------------------------------
------------------------------#0****#0**********#0**********#0**********#0****#0------------------------------
----------------------------#0********************#0**C0**#0********************#0----------------------------
--------------------------#0************#0**********#0**#0**********#0************#0--------------------------
------------------------#0****************#0**********#0**********#0****************#0------------------------
----------------------#0******************#0#0******************#0#0******************#0----------------------
------------------------#0**************#0----#0**************#0----#0**************#0------------------------
--------------------------#0**********#0--------#0**********#0--------#0**********#0--------------------------
----------------------------#0******#0------------#0******#0------------#0******#0----------------------------
------------------------------#0**#0----------------#0**#0----------------#0**#0------------------------------
--------------------------------#0--------------------#0--------------------#0--------------------------------
$
====
{
    "index": 1,
    "width": 5,
    "height": 5,
    "seed": 0,
    "roomWidth": 11,
    "roomHeight": 11
}
$
#4#0#0#0#0#0#0#0#0#0#0#0#0#0#0#0#0#0#0#0#0#0#0#0#0#0#0E0#0#0#0#0#0#0#0#0#0#0#0#0#0#0#0#0#0#0#0#0#0#0#0#0#0#0#5
#2******************#3#2******************#3#2******************#3#2******************#3#2******************#3
#2******************#3#2******************P3P2******************P3P2******************#3#2******************#3
#2******************#3#2******************#3#2******************#3#2******************#3#2******************#3
#2******************#3#2******************#3#2******************#3#2******************#3#2******************#3
#2******************#3#2******************#0#0#0#0#0#0#0#0#0#0#0#0#2******************#3#2******************#3
#2**********#4#0#0#0#0#0#0#0#0#0P0#0#0#0#0#0#0#0#0#0#0E1#0#0#0#0#0#0#0#0#0#0P0#0#0#0#0#0#0#0#0#0#5**********#3
#2**********#2**********************************************************************************#3**********#3
#2**********#2**********************************************************************************#3**********#3
#2**********#2**********************************************************************************#3**********#3
#2#1#1#1#1#1#2******#0#1#1#1#1#1P1#1#1#1#1#1#S#1#1#1#1#1#1#1#1#1#1#1#1#1#1#1P1#1#1#1#1#1#0******#3#1#1#1#1#1#3
#2#0#0#0#0#0#2******#3#4#0#0#0#0P0#0#0#0#0#5#4#0#0#0#0#0#0#0#0#0#5#4#0#0#0#0P0#0#0#0#0#5#2******#3#0#0#0#0#0#3
#2**********#2******#3#2******************#3#2******************#3#2******************#3#2******#3**********#3
#2**********#2******#3#2******************#3#2******************#3#2******************#3#2******#3**********#3
#2**********#2******#3#2******************#3#2******************#3#2******************#3#2******#3**********#3
#2**********#2******#3#2******************#3#2******************#3#2******************#3#2******#3**********#3
#2**********P2******P3P2******************P3P2******************P3P2******************P3P2******P3**********#3
#2**********#2******#3#2******************#3#2******************#3#2******************#3#2******#3**********#3
#2**********#2******#3#2******************#3#2******************#3#2******************#3#2******#3**********#3
#2**********#2******#3#2******************#3#2******************#3#2******************#3#2******#3**********#3
#2**********#2******#3#2******************#3#2******************#3#2******************#3#2******#3**********#3
#2#1#1#1#1#1#2******#3#6#1#1#1#1P1#1#1#1#1#7#6#1#1#1#1P1#1#1#1#1#7#6#1#1#1#1P1#1#1#1#1#7#2******#3#1#1#1#1#1#3
#2#0#0#0#0#0#2******#3#4#0#0#0#0P0#0#0#0#0#5#4#0#0#0#0P0#0#0#0#0#5#4#0#0#0#0P0#0#0#0#0#5#2******#3#0#0#0#0#0#3
#2**********#2******#3#2******************#3#2******************#3#2******************#3#2******#3**********#3
#2**********#2******#3#2******************#3#2******************#3#2******************#3#2******#3**********#3
#2**********#2******#3#2******************#3#2******************#3#2******************#3#2******#3**********#3
#2**********#2******#3#2******************#3#2******************#3#2******************#3#2******#3**********#3
#2**********P2******P3P2******************P3P2******************P3P2******************P3P2******P3**********#3
#2**********#2******#3#2******************#3#2******************#3#2******************#3#2******#3**********#3
#2**********#2******#3#2******************#3#2******************#3#2******************#3#2******#3**********#3
#2**********#2******#3#2******************#3#2******************#3#2******************#3#2******#3**********#3
#2**********#2******#3#2******************#3#2******************#3#2******************#3#2******#3**********#3
#2#1#1#1#1#1#2******#3#6#1#1#1#1P1#1#1#1#1#7#6#1#1#1#1P1#1#1#1#1#7#6#1#1#1#1P1#1#1#1#1#7#2******#3#1#1#1#1#1#3
#2#0#0#0#0#0#2******#3#4#0#0#0#0P0#0#0#0#0#5#4#0#0#0#0P0#0#0#0#0#5#4#0#0#0#0P0#0#0#0#0#5#2******#3#0#0#0#0#0#3
#2**********#2******#3#2******************#3#2******************#3#2******************#3#2******#3**********#3
#2**********#2******#3#2******************#3#2******************#3#2******************#3#2******#3**********#3
#2**********#2******#3#2******************#3#2******************#3#2******************#3#2******#3**********#3
#2**********#2******#3#2******************#3#2******************#3#2******************#3#2******#3**********#3
#2**********P2******P3P2******************P3P2******************P3P2******************P3P2******P3**********#3
#2**********#2******#3#2******************#3#2******************#3#2******************#3#2******#3**********#3
#2**********#2******#3#2******************#3#2******************#3#2******************#3#2******#3**********#3
#2**********#2******#3#2******************#3#2******************#3#2******************#3#2******#3**********#3
#2**********#2******#3#2******************#3#2******************#3#2******************#3#2******#3**********#3
#2#1#1#1#1#1#2******#3#6#1#1#1#1P1#1#1#1#1#7#6#1#1#1#1P1#1#1#1#1#7#6#1#1#1#1P1#1#1#1#1#7#2******#3#1#1#1#1#1#3
#2#0#0#0#0#0#2******#0#0#0#0#0#0P0#0#0#0#0#0#0#0#0#0#0P0#0#0#0#0#0#0#0#0#0#0P0#0#0#0#0#0#0******#3#0#0#0#0#0#3
#2**********#2**********************************************************************************#3**********#3
#2**********#2**********************************************************************************#3**********#3
#2**********#2**********************************************************************************#3**********#3
#2**********#6#1#1#1#1#1#1#1#1#1P1#1#1#1#1#1#1#1#1#1#1P1#1#1#1#1#1#1#1#1#1#1P1#1#1#1#1#1#1#1#1#1#7**********#3
#2******************#3#2******************#3#2******************#3#2******************#3#2******************#3
#2******************#3#2******************#3#2******************#3#2******************#3#2******************#3
#2******************#3#2******************#3#2******************#3#2******************#3#2******************#3
#2******************#3#2******************#3#2******************#3#2******************#3#2******************#3
#2******************#3#2******************#3#2******************#3#2******************#3#2******************#3
#6#1#1#1#1#1#1#1#1#1#1#1#1#1#1#1#1#1#1#1#1#1#1#1#1#1#1#1#1#1#1#1#1#1#1#1#1#1#1#1#1#1#1#1#1#1#1#1#1#1#1#1#1#1#7
$