{
    "chapter":999,
    "index": 0,
    "width": 3,
    "height": 3,
    "seed": 0,
    "roomWidth": 11,
    "roomHeight": 11,
    "floorRes":"tile_room",
    "floorCoverRes":"tile_room",
    "wallRes":"wall01anim002",
    "needRadomDecorate":false
}
$
#4#0#0#0#0#0#0#0#0#0#5#4#0#0#0#0#0#0#0#0#0#5#4#0#0#0#0#0#0#0#0#0#5
#2******************#3#2********W1********#3#2******************#3
#2******************#3#2******************#3#2******************#3
#2******************#3#2******************#3#2******************#3
#2******************#3#2******************#3#2******************#3
#2******************#3#2******************#3#2******************#3
#2******************#3#2******************#3#2******************#3
#2******************#3#2********g0********#3#2******************#3
#2******************#3#2******************#3#2******************#3
#2******************#3#2******************#3#2******************#3
#6#1#1#1#1#1#1#1#1#1#7#T#1#1#1#1#1#1#1#1P1#7#6#1#1#1#1#1#1#1#1#1#7
#4#0#0#0#0#0#0#0#0#0#5----------------#0P0#3#4#0#0#0#0#0#0#0#0#0#5
#2******************#3----------------#0**#3#2******************#3
#2******************#3----------------#0**#3#2******************#3
#2******************#3----#4#0#0#0#0#0#0**#3#2******************#3
#2******************#3----#2Z1Z0B0D1******#3#2******************#3
#2******************#3----#2**************#3#2******************#3
#2******************#3----#2************B1#3#2******************#3
#2******************#3----#6#1#1#1#1#1#1#1#7#2******************#3
#2******************#3----------------------#2******************#3
#2******************#3----------------------#2******************#3
#6#1#1#1#1#1#1#1#1#1#7-S--------------------#6#1#1#1#1#1#1#1#1#1#7
#4#0#0#0#0#0#0#0#0#0#5#4#0#0#0#0#0#0#0#0#0#5#4#0#0#0#0#0#0#0#0#0#5
#2******************#3#2******************#3#2******************#3
#2******************#3#2******************#3#2******************#3
#2******************#3#2******************#3#2******************#3
#2******************#3#2******************#3#2******************#3
#2******************#3#2******************#3#2******************#3
#2******************#3#2******************#3#2******************#3
#2******************#3#2******************#3#2******************#3
#2******************#3#2******************#3#2******************#3
#2******************#3#2******************#3#2******************#3
#6#1#1#1#1#1#1#1#1#1#7#6#1#1#1#1#1#1#1#1#1#7#6#1#1#1#1#1#1#1#1#1#7
$