{
    "index": 0,
    "width": 1,
    "height": 1,
    "seed": 0,
    "roomWidth": 33,
    "roomHeight": 33
}
$
----------------------#0#0#0#0#0#0#0#0#0#0#0----------------------
------------------#0#0#0#0******E0******#2#3#0#0------------------
--------------#0#0******************#3****#2****#0#0--------------
------------#0**********************P3****P2********#0------------
----------#0************************#3****#2**********#0----------
--------#0**************************#3****#2************#0--------
----#4#0****************************#7****#6**************#0#5----
----#2******************************************************#3----
----#2******************************************************#3**--
--#2**********************************************************#3--
--#2**********************************************************#3--
#2**************************************************************#3
#2**************************************************************#3
#2**************************************************************#3
#2**************************************************************#3
#2**************************************************************#3
#2**************************************************************#3
#2**************************************************************#3
#2**************************************************************#3
#2**************************************************************#3
#2**************************************************************#3
#2**************************************************************#3
--#2**********************************************************#3--
--#2**********************************************************#3--
----#2******************************************************#3----
----#2******************************************************#3----
----#6#1**************************************************#1#7----
--------#1**********************************************#1--------
----------#1******************************************#1----------
------------#1**************************************#1------------
--------------#1#1******************************#1#1--------------
------------------#1#1**********************#1#1------------------
----------------------#1#1#1#1#1#1#1#1#1#1#1----------------------
$
====
{
    "index": 1,
    "width": 11,
    "height": 11,
    "seed": 0,
    "roomWidth": 9,
    "roomHeight": 9
}
$
######################################################################################################################################################################################################
##################################################################################################################################################################################################**##
##******************####******************####******************####******************D0********************D0********************D0********************D0********************D0********************##
##******************####******************####******************####********************************************************************************************************************************##
##******************####******************####******************####********************************************************************************************************************************##
##******************####******************####******************####********************************************************************************************************************************##
##******************####******************####******************####********************************************************************************************************************************##
##******************####******************####******************####********************************************************************************************************************************##
##******************####******************####******************####********************************************************************************************************************************##
##################################################################################################################################################################################################**##
##################################################################################################################################################################################################**##
##******************####******************####******************####********************************************************************************************************************************##
##******************####******************####******************####********************************************************************************************************************************##
##******************####******************####******************####********************************************************************************************************************************##
##******************####******************####******************####********************************************************************************************************************************##
##******************####******************####******************####********************************************************************************************************************************##
##******************####******************####******************####********************************************************************************************************************************##
##******************####******************####******************####********************************************************************************************************************************##
##******************####******************####******************####********************************************************************************************************************************##
##******************####******************####******************####********************************************************************************************************************************##
##******************####******************####******************##################################################################################################################################**##
##******************####******************####******************##################################################################################################################################**##
##******************####******************####******************####********************************************************************************************************************************##
##******************####******************####******************####********************************************************************************************************************************##
##******************####******************####******************####********************************************************************************************************************************##
##******************####******************####******************####********************************************************************************************************************************##
##******************####******************####******************####********************************************************************************************************************************##
##******************####******************####******************####********************************************************************************************************************************##
##******************####******************####******************####********************************************************************************************************************************##
##******************####******************####******************####********************************************************************************************************************************##
##******************####******************####******************####********************************************************************************************************************************##
##******************####******************####******************####********************************************************************************************************************************##
##******************####******************####******************####********************************************************************************************************************************##
##******************####******************####******************####********************************************************************************************************************************##
##******************####******************####******************####********************************************************************************************************************************##
##******************####******************####******************####********************************************************************************************************************************##
##******************####******************####******************####********************************************************************************************************************************##
##******************####******************####******************####********************************************************************************************************************************##
##******************####******************####******************####********************************************************************************************************************************##
##******************####******************####******************####********************************************************************************************************************************##
##******************####******************####******************####********************************************************************************************************************************##
##******************####******************####******************####********************************************************************************************************************************##
##******************####******************####******************####********************************************************************************************************************************##
##******************####******************####******************####********************************************************************************************************************************##
##******************####******************####******************####********************************************************************************************************************************##
##******************####******************####******************####********************************************************************************************************************************##
##******************####******************####******************####********************************************************************************************************************************##
##******************####******************####******************####********************************************************************************************************************************##
##******************####******************####******************####********************************************************************************************************************************##
##******************####******************####******************####********************************************************************************************************************************##
##******************####******************####******************####********************************************************************************************************************************##
##******************####******************####******************####********************************************************************************************************************************##
##******************####******************####******************####********************************************************************************************************************************##
##******************####******************####******************####********************************************************************************************************************************##
##******************####******************####******************####********************************************************************************************************************************##
##******************####******************####******************####********************************************************************************************************************************##
##******************####******************####******************####********************************************************************************************************************************##
##******************####******************####******************####********************************************************************************************************************************##
##******************####******************####******************####********************************************************************************************************************************##
##******************####******************####******************####********************************************************************************************************************************##
##******************####******************####******************####********************************************************************************************************************************##
##******************####******************####******************####********************************************************************************************************************************##
##******************####******************####******************####********************************************************************************************************************************##
##******************####******************####******************####********************************************************************************************************************************##
##******************####******************####******************####********************************************************************************************************************************##
##******************####******************####******************####********************************************************************************************************************************##
##******************####******************####******************####********************************************************************************************************************************##
##******************####******************####******************####********************************************************************************************************************************##
##******************####******************####******************####********************************************************************************************************************************##
##******************####******************####******************####********************************************************************************************************************************##
##******************####******************####******************####********************************************************************************************************************************##
##******************####******************####******************####********************************************************************************************************************************##
##******************####******************####******************####********************************************************************************************************************************##
##******************####******************####******************####********************************************************************************************************************************##
##******************####******************####******************####********************************************************************************************************************************##
##******************####******************####******************####********************************************************************************************************************************##
##******************####******************####******************####********************************************************************************************************************************##
##******************####******************####******************####********************************************************************************************************************************##
##******************####******************####******************####********************************************************************************************************************************##
##******************####******************####******************####********************************************************************************************************************************##
##******************####******************####******************####********************************************************************************************************************************##
##******************####******************####******************####********************************************************************************************************************************##
##******************####******************####******************####********************************************************************************************************************************##
##******************####******************####******************####********************************************************************************************************************************##
##******************####******************####******************####********************************************************************************************************************************##
##******************####******************####******************####********************************************************************************************************************************##
##******************####******************####******************####********************************************************************************************************************************##
##******************####******************####******************####********************************************************************************************************************************##
##******************####******************####******************####********************************************************************************************************************************##
##******************####******************####******************####********************************************************************************************************************************##
##******************####******************####******************####********************************************************************************************************************************##
##******************####******************####******************####********************************************************************************************************************************##
##******************####******************####******************####********************************************************************************************************************************##
##******************####******************####******************####********************************************************************************************************************************##
##******************####******************####******************####********************************************************************************************************************************##
##******************####******************####******************####********************************************************************************************************************************##
##******************####******************####******************####********************************************************************************************************************************##
##******************####******************####******************####********************************************************************************************************************************##
######################################################################################################################################################################################################
$