{
    "index": 0,
    "width": 3,
    "height": 3,
    "seed": 0,
    "roomWidth": 11,
    "roomHeight": 11
}
$
------------------------------------------------------------------
------------------------------------------------------------------
------------------------------------------------------------------
------------------------------------------------------------------
------------------------------------------------------------------
--------------------------#0#0#0#0#0#0#0--------------------------
------------------------#0**************#0------------------------
----------------------#4******************#5----------------------
----------------------#2******************#3----------------------
----------------------P2******************P3----------------------
----------------------#6#1#1#1#1P1#1#1#1#1#7----------------------
--------------#4#0P0#3****#0#0#0P0#0#0#0****#4P0#0#5--------------
------------#0******#3**#4**************#5**#2******#0------------
----------#2********#3#2******************#3#2********#3----------
----------#2********#3#2******************#3#2********#3----------
----------#2********#3#2******************#3#2********#3----------
----------#2********P3P2******************P3P2********#3----------
----------#2********#3#2******************#3#2********#3----------
----------#2********#3#2******************#3#2********#3----------
----------#2********#3#2******************#3#2********#3----------
------------#0******#3**#6**************#7**#2******#0------------
--------------#6#1P1#7*S**#1#1#1P1#1#1#1****#6P1#1#7--------------
----------------------#4#0#0#0#0P0#0#0#0#0#5----------------------
----------------------P2****************--P3----------------------
----------------------#2******************#3----------------------
----------------------#6******************#7----------------------
------------------------#0**************#0------------------------
--------------------------#1#1#1#1#1#1#1--------------------------
------------------------------------------------------------------
------------------------------------------------------------------
------------------------------------------------------------------
------------------------------------------------------------------
------------------------------------------------------------------
$
====
{
    "index": 1,
    "width": 11,
    "height": 11,
    "seed": 0,
    "roomWidth": 9,
    "roomHeight": 9
}
$
######################################################################################################################################################################################################
##################################################################################################################################################################################################**##
##******************####******************####******************####******************D0********************D0********************D0********************D0********************D0********************##
##******************####******************####******************####********************************************************************************************************************************##
##******************####******************####******************####********************************************************************************************************************************##
##******************####******************####******************####********************************************************************************************************************************##
##******************####******************####******************####********************************************************************************************************************************##
##******************####******************####******************####********************************************************************************************************************************##
##******************####******************####******************####********************************************************************************************************************************##
##################################################################################################################################################################################################**##
##################################################################################################################################################################################################**##
##******************####******************####******************####********************************************************************************************************************************##
##******************####******************####******************####********************************************************************************************************************************##
##******************####******************####******************####********************************************************************************************************************************##
##******************####******************####******************####********************************************************************************************************************************##
##******************####******************####******************####********************************************************************************************************************************##
##******************####******************####******************####********************************************************************************************************************************##
##******************####******************####******************####********************************************************************************************************************************##
##******************####******************####******************####********************************************************************************************************************************##
##******************####******************####******************####********************************************************************************************************************************##
##******************####******************####******************##################################################################################################################################**##
##******************####******************####******************##################################################################################################################################**##
##******************####******************####******************####********************************************************************************************************************************##
##******************####******************####******************####********************************************************************************************************************************##
##******************####******************####******************####********************************************************************************************************************************##
##******************####******************####******************####********************************************************************************************************************************##
##******************####******************####******************####********************************************************************************************************************************##
##******************####******************####******************####********************************************************************************************************************************##
##******************####******************####******************####********************************************************************************************************************************##
##******************####******************####******************####********************************************************************************************************************************##
##******************####******************####******************####********************************************************************************************************************************##
##******************####******************####******************####********************************************************************************************************************************##
##******************####******************####******************####********************************************************************************************************************************##
##******************####******************####******************####********************************************************************************************************************************##
##******************####******************####******************####********************************************************************************************************************************##
##******************####******************####******************####********************************************************************************************************************************##
##******************####******************####******************####********************************************************************************************************************************##
##******************####******************####******************####********************************************************************************************************************************##
##******************####******************####******************####********************************************************************************************************************************##
##******************####******************####******************####********************************************************************************************************************************##
##******************####******************####******************####********************************************************************************************************************************##
##******************####******************####******************####********************************************************************************************************************************##
##******************####******************####******************####********************************************************************************************************************************##
##******************####******************####******************####********************************************************************************************************************************##
##******************####******************####******************####********************************************************************************************************************************##
##******************####******************####******************####********************************************************************************************************************************##
##******************####******************####******************####********************************************************************************************************************************##
##******************####******************####******************####********************************************************************************************************************************##
##******************####******************####******************####********************************************************************************************************************************##
##******************####******************####******************####********************************************************************************************************************************##
##******************####******************####******************####********************************************************************************************************************************##
##******************####******************####******************####********************************************************************************************************************************##
##******************####******************####******************####********************************************************************************************************************************##
##******************####******************####******************####********************************************************************************************************************************##
##******************####******************####******************####********************************************************************************************************************************##
##******************####******************####******************####********************************************************************************************************************************##
##******************####******************####******************####********************************************************************************************************************************##
##******************####******************####******************####********************************************************************************************************************************##
##******************####******************####******************####********************************************************************************************************************************##
##******************####******************####******************####********************************************************************************************************************************##
##******************####******************####******************####********************************************************************************************************************************##
##******************####******************####******************####********************************************************************************************************************************##
##******************####******************####******************####********************************************************************************************************************************##
##******************####******************####******************####********************************************************************************************************************************##
##******************####******************####******************####********************************************************************************************************************************##
##******************####******************####******************####********************************************************************************************************************************##
##******************####******************####******************####********************************************************************************************************************************##
##******************####******************####******************####********************************************************************************************************************************##
##******************####******************####******************####********************************************************************************************************************************##
##******************####******************####******************####********************************************************************************************************************************##
##******************####******************####******************####********************************************************************************************************************************##
##******************####******************####******************####********************************************************************************************************************************##
##******************####******************####******************####********************************************************************************************************************************##
##******************####******************####******************####********************************************************************************************************************************##
##******************####******************####******************####********************************************************************************************************************************##
##******************####******************####******************####********************************************************************************************************************************##
##******************####******************####******************####********************************************************************************************************************************##
##******************####******************####******************####********************************************************************************************************************************##
##******************####******************####******************####********************************************************************************************************************************##
##******************####******************####******************####********************************************************************************************************************************##
##******************####******************####******************####********************************************************************************************************************************##
##******************####******************####******************####********************************************************************************************************************************##
##******************####******************####******************####********************************************************************************************************************************##
##******************####******************####******************####********************************************************************************************************************************##
##******************####******************####******************####********************************************************************************************************************************##
##******************####******************####******************####********************************************************************************************************************************##
##******************####******************####******************####********************************************************************************************************************************##
##******************####******************####******************####********************************************************************************************************************************##
##******************####******************####******************####********************************************************************************************************************************##
##******************####******************####******************####********************************************************************************************************************************##
##******************####******************####******************####********************************************************************************************************************************##
##******************####******************####******************####********************************************************************************************************************************##
##******************####******************####******************####********************************************************************************************************************************##
##******************####******************####******************####********************************************************************************************************************************##
##******************####******************####******************####********************************************************************************************************************************##
##******************####******************####******************####********************************************************************************************************************************##
##******************####******************####******************####********************************************************************************************************************************##
##******************####******************####******************####********************************************************************************************************************************##
######################################################################################################################################################################################################
$