{
    "index": 1,
    "width": 9,
    "height": 9,
    "seed": 0,
    "roomWidth": 11,
    "roomHeight": 11
}
$
######################################################################################################################################################################################################
##E1##############E0##############################################################################################################################################################################**##
##******************####******************####******************####******************D0********************D0********************D0********************D0********************D0********************##
##******************####******************####******************####********************************************************************************************************************************##
##******************####******************####******************####********************************************************************************************************************************##
##******************####******************####******************####********************************************************************************************************************************##
##******************####******************####******************####********************************************************************************************************************************##
##******************####******************####******************####********************************************************************************************************************************##
##******************####******************####******************####********************************************************************************************************************************##
##################################################################################################################################################################################################**##
#S################################################################################################################################################################################################**##
##******************####******************####******************####********************************************************************************************************************************##
##******************####******************####******************####********************************************************************************************************************************##
##******************####******************####******************####********************************************************************************************************************************##
##******************####******************####******************####********************************************************************************************************************************##
##******************####******************####******************####********************************************************************************************************************************##
##******************####******************####******************####********************************************************************************************************************************##
##******************####******************####******************####********************************************************************************************************************************##
##******************####******************####******************####********************************************************************************************************************************##
##******************####******************####******************####********************************************************************************************************************************##
##******************####******************####******************##################################################################################################################################**##
##******************####******************####******************##################################################################################################################################**##
##******************####******************####******************####********************************************************************************************************************************##
##******************####******************####******************####********************************************************************************************************************************##
##******************####******************####******************####********************************************************************************************************************************##
##******************####******************####******************####********************************************************************************************************************************##
##******************####******************####******************####********************************************************************************************************************************##
##******************####******************####******************####********************************************************************************************************************************##
##******************####******************####******************####********************************************************************************************************************************##
##******************####******************####******************####********************************************************************************************************************************##
##******************####******************####******************####********************************************************************************************************************************##
##******************####******************####******************####********************************************************************************************************************************##
##******************####******************####******************####********************************************************************************************************************************##
##******************####******************####******************####********************************************************************************************************************************##
##******************####******************####******************####********************************************************************************************************************************##
##******************####******************####******************####********************************************************************************************************************************##
##******************####******************####******************####********************************************************************************************************************************##
##******************####******************####******************####********************************************************************************************************************************##
##******************####******************####******************####********************************************************************************************************************************##
##******************####******************####******************####********************************************************************************************************************************##
##******************####******************####******************####********************************************************************************************************************************##
##******************####******************####******************####********************************************************************************************************************************##
##******************####******************####******************####********************************************************************************************************************************##
##******************####******************####******************####********************************************************************************************************************************##
##******************####******************####******************####********************************************************************************************************************************##
##******************####******************####******************####********************************************************************************************************************************##
##******************####******************####******************####********************************************************************************************************************************##
##******************####******************####******************####********************************************************************************************************************************##
##******************####******************####******************####********************************************************************************************************************************##
##******************####******************####******************####********************************************************************************************************************************##
##******************####******************####******************####********************************************************************************************************************************##
##******************####******************####******************####********************************************************************************************************************************##
##******************####******************####******************####********************************************************************************************************************************##
##******************####******************####******************####********************************************************************************************************************************##
##******************####******************####******************####********************************************************************************************************************************##
##******************####******************####******************####********************************************************************************************************************************##
##******************####******************####******************####********************************************************************************************************************************##
##******************####******************####******************####********************************************************************************************************************************##
##******************####******************####******************####********************************************************************************************************************************##
##******************####******************####******************####********************************************************************************************************************************##
##******************####******************####******************####********************************************************************************************************************************##
##******************####******************####******************####********************************************************************************************************************************##
##******************####******************####******************####********************************************************************************************************************************##
##******************####******************####******************####********************************************************************************************************************************##
##******************####******************####******************####********************************************************************************************************************************##
##******************####******************####******************####********************************************************************************************************************************##
##******************####******************####******************####********************************************************************************************************************************##
##******************####******************####******************####********************************************************************************************************************************##
##******************####******************####******************####********************************************************************************************************************************##
##******************####******************####******************####********************************************************************************************************************************##
##******************####******************####******************####********************************************************************************************************************************##
##******************####******************####******************####********************************************************************************************************************************##
##******************####******************####******************####********************************************************************************************************************************##
##******************####******************####******************####********************************************************************************************************************************##
##******************####******************####******************####********************************************************************************************************************************##
##******************####******************####******************####********************************************************************************************************************************##
##******************####******************####******************####********************************************************************************************************************************##
##******************####******************####******************####********************************************************************************************************************************##
##******************####******************####******************####********************************************************************************************************************************##
##******************####******************####******************####********************************************************************************************************************************##
##******************####******************####******************####********************************************************************************************************************************##
##******************####******************####******************####********************************************************************************************************************************##
##******************####******************####******************####********************************************************************************************************************************##
##******************####******************####******************####********************************************************************************************************************************##
##******************####******************####******************####********************************************************************************************************************************##
##******************####******************####******************####********************************************************************************************************************************##
##******************####******************####******************####********************************************************************************************************************************##
##******************####******************####******************####********************************************************************************************************************************##
##******************####******************####******************####********************************************************************************************************************************##
##******************####******************####******************####********************************************************************************************************************************##
##******************####******************####******************####********************************************************************************************************************************##
##******************####******************####******************####********************************************************************************************************************************##
##******************####******************####******************####********************************************************************************************************************************##
##******************####******************####******************####********************************************************************************************************************************##
##******************####******************####******************####********************************************************************************************************************************##
##******************####******************####******************####********************************************************************************************************************************##
##******************####******************####******************####********************************************************************************************************************************##
##******************####******************####******************####********************************************************************************************************************************##
######################################################################################################################################################################################################
$